-2.451488819306989891e-02,2.444326511378543398e-01,4.952161733045090664e-01,4.564773047053919397e-01,-7.007319609112799830e-02,-3.776427248680160331e-01,-3.030975537572210277e-01,-1.139880782731869518e-01
1.804640896738758937e-01,4.180376009255432068e-01,3.361503525277727000e-01,-6.966750006662736361e-02,-3.452994866290953202e-01,-1.590304140727135107e-01,1.480488678241325962e-01,1.490732202965222020e-01
3.393999134894697955e-01,2.714371079702078693e-01,-4.680613860409942040e-02,-3.314119100001047813e-01,-2.366413844753790241e-01,2.089514216423697390e-01,4.612644193455160413e-01,1.591093720364259445e-01
2.418894552480679305e-01,7.808227225485138423e-03,-2.365965835234067338e-01,-1.630206708927231241e-01,1.958203972194447889e-02,3.155501908957887292e-01,4.075337667025213384e-01,-1.348174421532558065e-02
1.294606580016256503e-01,-2.087211634674357441e-01,-2.113309862204873490e-01,3.927749568071328690e-02,6.164092375402373258e-02,3.424179037852524976e-01,4.004396216074404546e-01,-2.479506469152925330e-01
1.134513968610894041e-01,-7.786181326310842588e-02,1.155933025092120148e-01,3.946125426020643534e-01,4.119995954689446571e-01,4.191629807309570910e-01,3.499549771620657362e-03,-5.371434890471288304e-01
1.053644342555511981e-01,7.113251381802437878e-02,3.313987318871411403e-01,3.950867104976161781e-01,-3.324375833468838637e-02,-2.946919979878222517e-01,-4.337663572965834158e-01,-2.439318881506104819e-01
1.005068540677242772e-01,1.127929306222127392e-01,1.023157214370223542e-02,-3.089120588918390364e-01,-5.570077518119774806e-01,-3.194067612501254594e-01,-2.728981389415337938e-02,1.220794403527309391e-01
